Gender	Gender
YearOfBirth	Year of birth
State	State
HeightMedian	Height median
WeightMedian	Weight median
WeightMaxT	Weight truncated max
BMIMaxT	BMI truncated max
BMIMinT	BMI truncated min
BMIMedian	BMI median
RangeBMI	Range BMI
SystolicBPMaxT	Systolic BP truncated max
SystolicBPMinT	Systolic BP truncated min
SystolicBPMedian	Systolic BP median
DiastolicBPMaxT	Diastolic BP truncated max
DiastolicBPMinT	Diastolic BP truncated min
DiastolicBPMedian	Diastolic BP median
RangeSystolicBP	Range systolic BP
RangeDiastolicBP	Range diastolic BP
HighLowBP	High Low difference BP
RespiratoryRateMaxT	Respiratory rate truncated max
RespiratoryRateMedian	Respiratory rate median
TemperatureRank2th	Temperature second lowest
TemperatureMedian	Temperature median
PrevSmoker	Previous smoker
Smoker	Smoker status
InternalMedicine	Internal medicine
CardiovascularDisease	Cardiovascular disease
FamilyPractice	Family practice
GeneralPractice	General practice
Podiatry	Podiatry
NumSpecialties	Number of specialties
VisitYearBlank	Visits with year blank
VisitYear2009	Visits in year 2009
VisitYear2010	Visits in year 2010
VisitYear2011	Visits in year 2011
VisitYear2012	Visits in year 2012
VisitTotal	Visits total
MaxVisitYear	Max visits per year
FirstYear	First year with visits
LastYear	Last year with visits
RangeYear	Range year (last -first)
Years2Date	Range year (2012 - first)
MaxVisitWYear	Max visits per weighted year
MinVisit2Date	Min visits a year (to date)
MinVisit2Last	Min visits a year (to last year with visits)
NumPhysicians	Number of physicians
VisitPerWYear2Date	Visits per weighted year (to date)
VisitPerWYear2Last	Visits per weighted year (to last year with visits)
Heighted	Visits with not null height
Weighted	Visits with not null weight
L2_AbdominalHernia	Abdominal hernia (level 2)(number of transcript diagnostics)
L2_AbdominalPain	Abdominal pain (level 2)(number of diagnostics)
L2_AbuseMonotoring	Abuse monotoring (level 2)(number of diagnostics)
L2_Acne	Acne (level 2)(number of diagnostics)
L2_AcuteBronchitis	Acute bronchitis (level 2)(number of diagnostics)
L2_AcuteCystitis	Acute cystitis (level 2)(number of diagnostics)
L2_Alcohol	Alcohol (level 2)(number of diagnostics)
L2_Allergy	Allergy (level 2)(number of diagnostics)
L2_AMI	AMI (level 2)(number of diagnostics)
L2_AnginaPectoris	Angina pectoris (level 2)(number of diagnostics)
L2_Anxiety	Anxiety (level 2)(number of diagnostics)
L2_Arthropathy	Arthropathy (level 2)(number of diagnostics)
L2_Asthma	Asthma (level 2)(number of diagnostics)
L2_AtherosclerosisCoronary	Atherosclerosis coronary (level 2)(number of diagnostics)
L2_AtherosclerosisPeripheral	Atherosclerosis peripheral (level 2)(number of diagnostics)
L2_BackPain	Back pain (level 2)(number of diagnostics)
L2_Bladder	Bladder (level 2)(number of diagnostics)
L2_BlindDeficiency	Blind deficiency (level 2)(number of diagnostics)
L2_BloodAnormal	Blood anormal (level 2)(number of diagnostics)
L2_BoneCartilage	Bone cartilage (level 2)(number of diagnostics)
L2_BoneDeformity	Bone deformity (level 2)(number of diagnostics)
L2_Calculus	Calculus (level 2)(number of diagnostics)
L2_Candida	Candida (level 2)(number of diagnostics)
L2_CaProstate	Ca prostate (level 2)(number of diagnostics)
L2_CardiacInsufficiency	Cardiac insufficiency (level 2)(number of diagnostics)
L2_CardiacOther	Cardiac other (level 2)(number of diagnostics)
L2_CardiacValve	Cardiac valve (level 2)(number of diagnostics)
L2_CarpalSyndrome	Carpal syndrome (level 2)(number of diagnostics)
L2_CaSkin	Ca skin (level 2)(number of diagnostics)
L2_Cataract	Cataract (level 2)(number of diagnostics)
L2_Cellulitis	Cellulitis (level 2)(number of diagnostics)
L2_CerebralDegeneration	Cerebral degeneration (level 2)(number of diagnostics)
L2_CerebroVascular	Cerebro vascular (level 2)(number of diagnostics)
L2_Cerumen	Earwax (level 2)(number of diagnostics)
L2_Cervical	Cervical (level 2)(number of diagnostics)
L2_ChestPain	Chest pain (level 2)(number of diagnostics)
L2_ChronicCystitis	Chronic cystitis (level 2)(number of diagnostics)
L2_ChronicPainSynd	Chronic pain syndrome (level 2)(number of diagnostics)
L2_ChronicRenalFailure	Chronic renal failure (level 2)(number of diagnostics)
L2_Coagulation	Coagulation (level 2)(number of diagnostics)
L2_ColitisNoninfectious	Colitis no infectious (level 2)(number of diagnostics)
L2_Conjunctivitis	Conjunctivitis (level 2)(number of diagnostics)
L2_Constipation	Constipation (level 2)(number of diagnostics)
L2_COPD	COPD (level 2)(number of diagnostics)
L2_Corns	Corns (level 2)(number of diagnostics)
L2_Cough	Cough (level 2)(number of diagnostics)
L2_CRP	CRP (level 2)(number of diagnostics)
L2_DeficiencyAnemia	Deficiency anemia (level 2)(number of diagnostics)
L2_Dementia	Dementia (level 2)(number of diagnostics)
L2_Dermatitis	Dermatitis (level 2)(number of diagnostics)
L2_Diarrhea	Diarrhea (level 2)(number of diagnostics)
L2_DieteticMonotoring	Dietetic monitoring (level 2)(number of diagnostics)
L2_DigestiveBleeding	Digestive bleeding (level 2)(number of diagnostics)
L2_DigestiveUlcer	Digestive ulcer (level 2)(number of diagnostics)
L2_Diverticula	Diverticula (level 2)(number of diagnostics)
L2_DMII	DMII sure related (level 2)(number of diagnostics)
L2_DMRelated	DM medium Related (level 2)(number of diagnostics)
L2_DMRelated2	DM high Related (level 2)(number of diagnostics)
L2_Drug	Drug (level 2)(number of diagnostics)
L2_DrugOther	Drug other (level 2)(number of diagnostics)
L2_Dysphagia	Dysphagia (level 2)(number of diagnostics)
L2_Dyspnea	Dyspnea (level 2)(number of diagnostics)
L2_Dysrhythmia	Dysrhythmia (level 2)(number of diagnostics)
L2_Dysuria	Dysuria (level 2)(number of diagnostics)
L2_Edema	Edema (level 2)(number of diagnostics)
L2_EKGAbnormal	EKG abnormal (level 2)(number of diagnostics)
L2_Elbow	Elbow (level 2)(number of diagnostics)
L2_EndocrineOther	Endocrine other (level 2)(number of diagnostics)
L2_Enthesopathy	Enthesopathy (level 2)(number of diagnostics)
L2_Epilepsy	Epilepsy (level 2)(number of diagnostics)
L2_Esophagus	Esophagus (level 2)(number of diagnostics)
L2_EssentialTremor	Essential tremor (level 2)(number of diagnostics)
L2_Exanthem	Exanthem (level 2)(number of diagnostics)
L2_ExternalOtitis	External otitis (level 2)(number of diagnostics)
L2_EyeInfection	Eye infection (level 2)(number of diagnostics)
L2_EyeOther	Eye other (level 2)(number of diagnostics)
L2_FamilyCV	Family cardiovascular history (level 2)(number of diagnostics)
L2_FamilyDM	Family diabetes history (level 2)(number of diagnostics)
L2_Fever	Fever (level 2)(number of diagnostics)
L2_Fibromatoses	Fibromatoses (level 2)(number of diagnostics)
L2_Flatulence	Flatulence (level 2)(number of diagnostics)
L2_Flu	Flu (level 2)(number of diagnostics)
L2_FluidDisorder	Fluid disorder (level 2)(number of diagnostics)
L2_Furuncle	Furuncle (level 2)(number of diagnostics)
L2_GallBladder	Gall bladder (level 2)(number of diagnostics)
L2_GastricFunctional	Gastric functional (level 2)(number of diagnostics)
L2_GastritisDuodenitis	Gastritis duodenitis (level 2)(number of diagnostics)
L2_Glaucoma	Glaucoma (level 2)(number of diagnostics)
L2_GlucoseAbnormal	Glucose abnormal (level 2)(number of diagnostics)
L2_Goitier	Goitier (level 2)(number of diagnostics)
L2_Gout	Gout (level 2)(number of diagnostics)
L2_HairDisease	Hair disease (level 2)(number of diagnostics)
L2_Headache	Headache (level 2)(number of diagnostics)
L2_Healthy	Healthy (level 2)(number of diagnostics)
L2_Hearing	Hearing (level 2)(number of diagnostics)
L2_Hematury	Hematury (level 2)(number of diagnostics)
L2_Hemorrhagic	Hemorrhagic (level 2)(number of diagnostics)
L2_HemorrhagicAnemia	Hemorrhagic anemia (level 2)(number of diagnostics)
L2_Hemorrhoids	Hemorrhoids (level 2)(number of diagnostics)
L2_Hepatitis	Hepatitis (level 2)(number of diagnostics)
L2_Hepatobiliary	Hepatobiliary (level 2)(number of diagnostics)
L2_HerpesSimplex	Herpes simplex (level 2)(number of diagnostics)
L2_HerpesZoster	Herpes zoster (level 2)(number of diagnostics)
L2_HighBP	High BP without hypertension (level 2)(number of diagnostics)
L2_Hypercholesterolemia	Hypercholesterolemia (level 2)(number of diagnostics)
L2_Hyperkalemia	Hyperkalemia (level 2)(number of diagnostics)
L2_HyperlipOther	Hyperlipemic other (level 2)(number of diagnostics)
L2_HypertensionComp	Hypertension complicated (level 2)(number of diagnostics)
L2_HypertensionEssential	Hypertension essential (level 2)(number of diagnostics)
L2_Hypertriglyceridemia	Hypertriglyceridemia (level 2)(number of diagnostics)
L2_Hypoglycemia	Hypoglycemia (level 2)(number of diagnostics)
L2_Hypokalemia	Hypokalemia (level 2)(number of diagnostics)
L2_Hyposmolarity	Hyposmolarity (level 2)(number of diagnostics)
L2_Hypotension	Hypotension (level 2)(number of diagnostics)
L2_Hypothyroidism	Hypothyroidism (level 2)(number of diagnostics)
L2_Impetigo	Impetigo (level 2)(number of diagnostics)
L2_ImpGlucoseAbnormal	Impaired glucose abnormal (level 2)(number of diagnostics)
L2_Impotence	Impotence (level 2)(number of diagnostics)
L2_InadequatedDiet	Inadequated diet (level 2)(number of diagnostics)
L2_Insomnia	Insomnia (level 2)(number of diagnostics)
L2_InsomnioNO	Insomnio (no organic) (level 2)(number of diagnostics)
L2_IntestinalInfection	Intestinal infection (level 2)(number of diagnostics)
L2_IntestinalMalabsorption	Intestinal malabsorption (level 2)(number of diagnostics)
L2_IronAnemia	Iron anemia (level 2)(number of diagnostics)
L2_IrritableBowel	Irritable bowel (level 2)(number of diagnostics)
L2_Leukocytes	Leukocytes (level 2)(number of diagnostics)
L2_LichenPruritus	Lichen pruritus (level 2)(number of diagnostics)
L2_LimbCramp	Limb cramp (level 2)(number of diagnostics)
L2_LimbPain	Limb pain (level 2)(number of diagnostics)
L2_LiverAbnormal	Liver abnormal (level 2)(number of diagnostics)
L2_LumbarPain	Lumbar pain (level 2)(number of diagnostics)
L2_Lymphadenitis	Lymphadenitis (level 2)(number of diagnostics)
L2_Malaise	Malaise (level 2)(number of diagnostics)
L2_MaleGenitalInf	Male genital infection (level 2)(number of diagnostics)
L2_Malnutrition	Malnutrition (level 2)(number of diagnostics)
L2_MemoryLoss	Memory loss (level 2)(number of diagnostics)
L2_Menopausal	Menopausal (level 2)(number of diagnostics)
L2_MenstruationDisorder	Menstruation disorder (level 2)(number of diagnostics)
L2_MentalMiscelanea	Mental miscelanea (level 2)(number of diagnostics)
L2_MentalRetardation	Mental retardation (level 2)(number of diagnostics)
L2_MetabolicMineral	Metabolic mineral (level 2)(number of diagnostics)
L2_MetabolicOther	Metabolic other (level 2)(number of diagnostics)
L2_Migraine	Migraine (level 2)(number of diagnostics)
L2_MixedHyperlipidemia	Mixed hyperlipidemia (level 2)(number of diagnostics)
L2_Mixuria	Mixuria (level 2)(number of diagnostics)
L2_MoodDisorder	Mood disorder (level 2)(number of diagnostics)
L2_MuscleSpasm	Muscle spasm (level 2)(number of diagnostics)
L2_Myalgia	Myalgia (level 2)(number of diagnostics)
L2_MycosisFoot	Mycosis foot (level 2)(number of diagnostics)
L2_MycosisOther	Mycosis other (level 2)(number of diagnostics)
L2_Myopathy	Myopathy (level 2)(number of diagnostics)
L2_Nails	Nails disease (level 2)(number of diagnostics)
L2_NasalCavity	Nasal cavity (level 2)(number of diagnostics)
L2_NeoSkin	Neo skin (level 2)(number of diagnostics)
L2_NervousSystem	Nervous system (level 2)(number of diagnostics)
L2_NervousSystemOther	Nervous system other (level 2)(number of diagnostics)
L2_NeurRadiculitis	Neuritis radiculitis (level 2)(number of diagnostics)
L2_Nocturia	Nocturia (level 2)(number of diagnostics)
L2_NonFollow	Non follow of treatment (level 2)(number of diagnostics)
L2_Obesity	Obesity (level 2)(number of diagnostics)
L2_OpenWound	Open wound (level 2)(number of diagnostics)
L2_Oral	Oral (level 2)(number of diagnostics)
Feature	Description
L2_Osteoarthrosis	Osteoarthrosis (level 2)(number of diagnostics)
L2_Osteoporosis	Osteoporosis (level 2)(number of diagnostics)
L2_Otalgia	Otalgia (level 2)(number of diagnostics)
L2_OtherInfection	Other infection (level 2)(number of diagnostics)
L2_OtitisMedia	Otitis media (level 2)(number of diagnostics)
L2_OvarianCyst	Ovarian cyst (level 2)(number of diagnostics)
L2_Ovaries	Ovaries (level 2)(number of diagnostics)
L2_Overweight	Overweight (level 2)(number of diagnostics)
L2_PainJoint	Pain joint (level 2)(number of diagnostics)
L2_Pancreas	Pancreas (level 2)(number of diagnostics)
L2_ParasiteInfection	Parasite infection (level 2)(number of diagnostics)
L2_Parkinson	Parkinson (level 2)(number of diagnostics)
L2_PerEndMiocard	Pericardic endocardic miocardic (level 2)(number of diagnostics)
L2_PeriphNeuropathy	Peripheral neuropathy (level 2)(number of diagnostics)
L2_Pneumonia	Pneumonia (level 2)(number of diagnostics)
L2_PNS	Peripheral nervous system (level 2)(number of diagnostics)
L2_PNSFace	Nervous system face (level 2)(number of diagnostics)
L2_PNSInflamToxic	PNS Inflamatory or Toxic (level 2)(number of diagnostics)
L2_Polydipsia	Polydipsia (level 2)(number of diagnostics)
L2_Polyuria	Polyuria (level 2)(number of diagnostics)
L2_Proctology	Proctology (level 2)(number of diagnostics)
L2_ProstateBenign	Prostate benign (level 2)(number of diagnostics)
L2_Proteinuria	Proteinuria (level 2)(number of diagnostics)
L2_PSA	PSA (level 2)(number of diagnostics)
L2_Psoriasis	Psoriasis (level 2)(number of diagnostics)
L2_Pyrosis	Pyrosis (level 2)(number of diagnostics)
L2_Renal	Renal (level 2)(number of diagnostics)
L2_RespiratoryFail	Respiratory fail (level 2)(number of diagnostics)
L2_RespUpAcute	Respiratory upper chronic (level 2)(number of diagnostics)
L2_RespUpChronic	Respiratory upper acute (level 2)(number of diagnostics)
L2_RheumaticPain	Rheumatic pain (level 2)(number of diagnostics)
L2_Rhinitis	Rhinitis (level 2)(number of diagnostics)
L2_RLS	Restless legs syndrome (level 2)(number of diagnostics)
L2_Schizophrenic	Schizophrenic (level 2)(number of diagnostics)
L2_SciaticPain	Sciatic pain (level 2)(number of diagnostics)
L2_Screening	Screening (level 2)(number of diagnostics)
L2_SeborrheicCyst	Seborrheic cyst (level 2)(number of diagnostics)
L2_SeborrheicDermatitis	Seborrheic dermatitis (level 2)(number of diagnostics)
L2_SexDysfunction	Sex dysfunction (level 2)(number of diagnostics)
L2_Shoulder	Shoulder (level 2)(number of diagnostics)
L2_Sinus	Sinus (level 2)(number of diagnostics)
L2_SkinAtrophic	Skin atrophic (level 2)(number of diagnostics)
L2_SkinInflammatory	Skin inflammatory (level 2)(number of diagnostics)
L2_SkinKeratosis	Skin keratosis (level 2)(number of diagnostics)
L2_SkinOther	Skin other (level 2)(number of diagnostics)
L2_SkinSense	Skin sense (level 2)(number of diagnostics)
L2_SkinViric	Skin viric (level 2)(number of diagnostics)
L2_Sleep	Sleep (level 2)(number of diagnostics)
L2_SleepApnea	Sleep apnea (level 2)(number of diagnostics)
L2_SpinalStenosis	Spinal stenosis (level 2)(number of diagnostics)
L2_Spondylosis	Spondylosis (level 2)(number of diagnostics)
L2_Sprains	Sprains (level 2)(number of diagnostics)
L2_Stress	Stress (level 2)(number of diagnostics)
L2_SuperficialInjury	Superficial injury (level 2)(number of diagnostics)
L2_SweatGland	Sweat gland (level 2)(number of diagnostics)
L2_Syncope	Syncope (level 2)(number of diagnostics)
L2_SyndromeX	Syndrome X (level 2)(number of diagnostics)
L2_SynoviumTendon	Synovium and tendon (level 2)(number of diagnostics)
L2_Teeth	Teeth (level 2)(number of diagnostics)
L2_Temporomandibular	Temporomandibular (level 2)(number of diagnostics)
L2_TensionalPsicalgia	Tensional psicalgia (level 2)(number of diagnostics)
L2_TesticularDysfunction	Testicular dysfunction (level 2)(number of diagnostics)
L2_ThyroidOther	Thyroid other (level 2)(number of diagnostics)
L2_Tobacco	Tobacco (level 2)(number of diagnostics)
L2_TonsilsAdenoids	Tonsils and adenoids (level 2)(number of diagnostics)
L2_TriggerFinger	Trigger finger (level 2)(number of diagnostics)
L2_Ulcer	Ulcer (level 2)(number of diagnostics)
L2_UlcerousColitis	Ulcerous colitis (level 2)(number of diagnostics)
L2_UrinaryIncontinency	Urinary incontinency (level 2)(number of diagnostics)
L2_UrinaryUrgency	Urinary urgency (level 2)(number of diagnostics)
L2_Urticaria	Urticaria (level 2)(number of diagnostics)
L2_UTIOther	UTI Other (level 2)(number of diagnostics)
L2_Vaccine	Vaccine (level 2)(number of diagnostics)
L2_Vaginal	Vaginal (level 2)(number of diagnostics)
L2_VarixLeg	Varix leg (level 2)(number of diagnostics)
L2_VascularPeripheral	Vascular peripheral (level 2)(number of diagnostics)
L2_VertiginousSyndromes	Vertiginous syndromes (level 2)(number of diagnostics)
L2_VIH	Vih (level 2)(number of diagnostics)
L2_VitaminB	Vitamin B (level 2)(number of diagnostics)
L2_VitaminD	Vitamin D (level 2)(number of diagnostics)
L2_VomitingNausea	Vomiting and nausea (level 2)(number of diagnostics)
L2_WeightGain	Weight gain (level 2)(number of diagnostics)
L2_WeightLoss	Weight loss (level 2)(number of diagnostics)
L1_Anemia	Anemia (level 1)(number of diagnostics)
L1_Back	Back (level 1)(number of diagnostics)
L1_ColitisMSC	Colitis miscelanea (level 1)(number of diagnostics)
L1_ConnectiveTissue	Connective tissue (level 1)(number of diagnostics)
L1_Dermatitis	Dermatitis (level 1)(number of diagnostics)
L1_Digestive	Digestive (level 1)(number of diagnostics)
L1_DMSymptom	DM Symptom (level 1)(number of diagnostics)
L1_Glucose	Glucose (level 1)(number of diagnostics)
L1_Headache	Headache (level 1)(number of diagnostics)
L1_Herpes	Herpes (level 1)(number of diagnostics)
L1_Hormonal	Hormonal (level 1)(number of diagnostics)
L1_Insomnia	Insomnia (level 1)(number of diagnostics)
L1_IschemicCardiopathy	Ischemic cardiopathy (level 1)(number of diagnostics)
L1_MycosisFoot	Mycosis foot (level 1)(number of diagnostics)
L1_NervousSystemOther	Nervous system other (level 1)(number of diagnostics)
L1_Prostate	Prostate (level 1)(number of diagnostics)
L1_RespInfec	Respinfec (level 1)(number of diagnostics)
L1_Skin	Skin (level 1)(number of diagnostics)
L1_SkinInfection	Skin infection (level 1)(number of diagnostics)
L1_SkinInflammatory	Skin inflammatory (level 1)(number of diagnostics)
L1_SkinOther	Skin other (level 1)(number of diagnostics)
StartYear	Oldest start year of all diagnostics
PreviousYear	Number of diagnostics with start year < 2009
DiffDMOtherRelatedSymptoms	Number of different level1 with level2=DMSymptom
VisitsDMOtherRelatedSymptoms	Visits with diagnostics with level2=DMSymptom
DiffLevel2Diag	Different level 2 categories with diagnostics
Tot3digitICD9	Different 3 digit icd9 categories with diagnostics
TotDiagWYear	Total diagnostics per weighted year
TotDiag	Total diagnostics
TotDiagPerVisit	Total diagnostics per visit
TotDiagWOTranscript	Total diagnostics without transcripts
acetaminophen_bin	Acetaminophen (binary)
acetaminophen_dose	Acetaminophen (max dose)
acetaminophen_npr	Acetaminophen (prescriptions)
ACEI_bin	ACEI (binary)
benazepril_bin	Benazepril (binary)
benazepril_dose	Benazepril (max dose)
enalapril_bin	Enalapril (binary)
enalapril_dose	Enalapril (max dose)
ramipril_bin	Ramipril (binary)
ramipril_dose	Ramipril (max dose)
lisinopril_bin	Lisinopril (binary)
lisinopril_dose	Lisinopril (max dose)
ACEI_dose	ACEI (max dose)
ACEI_npr	ACEI (prescriptions)
aspirin_bin	Aspirin (binary)
aspirin_dose	Aspirin (max dose)
aspirin_npr	Aspirin (prescriptions)
Feature	Description
losartan_bin	Losartan (binary)
olmesartan_bin	Olmesartan (binary)
telmisartan_bin	Telmisartan (binary)
valsartan_bin	Valsartan (binary)
losartan_npr	Losartan (prescriptions)
olmesartan_npr	Olmesartan (prescriptions)
telmisartan_npr	Telmisartan (prescriptions)
valsartan_npr	Valsartan (prescriptions)
losartan_dose	Losartan (max dose)
olmesartan_dose	Olmesartan (max dose)
telmisartan_dose	Telmisartan (max dose)
valsartan_dose	Valsartan (max dose)
AIIRA_nap	AIIRA (different active principles)
AIIRA_bin	AIIRA (binary)
losartan_telmisartan_dose	Losartan (max dose)
AIIRA_npr	AIIRA (prescriptions)
antifungical_general_npr	Antifungal (prescriptions)
antifungical_general_nap	Antifungal (different active principles)
antifungical_general_bin	Antifungal (binary)
antifungical_topical_npr	Antifungal (prescriptions)
antifungical_topical_nap	Antifungal (different active principles)
antifungical_topical_bin	Antifungal (binary)
antiplatelet_bin	Antiplatelet (binary)
antiplatelet_dose	Antiplatelet (max dose)
antiplatelet_npr	Antiplatelet (prescriptions)
alprazolam_bin	Alprazolam (binary)
alprazolam_dose	Alprazolam (max dose)
clonazepam_bin	Clonazepam (binary)
clonazepam_dose	Clonazepam (max dose)
diazepam_bin	Diazepam (binary)
diazepam_dose	Diazepam (max dose)
lorazepam_bin	Lorazepam (binary)
lorazepam_dose	Lorazepam (max dose)
temazepam_bin	Temazepam (binary)
temazepam_dose	Temazepam (max dose)
benzodiazepine_nap	Benzodiazepine (different active principles)
benzodiazepine_bin	Benzodiazepine (binary)
benzodiazepine_npr	Benzodiazepine (prescriptions)
atenolol_bin	Atenolol (binary)
atenolol_npr	Atenolol (prescriptions)
atenolol_dose	Atenolol (max dose)
carvedilol_bin	Carvedilol (binary)
carvedilol_npr	Carvedilol (prescriptions)
carvedilol_dose	Carvedilol (max dose)
Feature	Description
metoprolol_bin	Metoprolol (binary)
metoprolol_dose	Metoprolol (max dose)
nebivolol_bin	Nebivolol (binary)
nebivolol_dose	Nebivolol (max dose)
propranolol_bin	Propranolol (binary)
propranolol_dose	Propranolol (max dose)
betablocker_nap	Betablocker (different active principles)
betablocker_bin	Betablocker (binary)
betablocker_npr	Betablocker (prescriptions)
fenofibrate_dose	Fenofibrate (max dose)
fenofibric_acid_dose	Fenofibric (max dose)
gemfibrozil_dose	Gemfibrozil (max dose)
fenofibrate_bin	Fenofibrate (binary)
fenofibric_acid_bin	Fenofibric (binary)
gemfibrozil_bin	Gemfibrozil (binary)
fibrate_npr	Fibrate (prescriptions)
fibrate_bin	Fibrate (binary)
fibrate_nap	Fibrate (different active principles)
gabapentin_dose	Gabapentin (max dose)
pregabalin_dose	Pregabalin (max dose)
gabapentin_bin	Gabapentin (binary)
pregabalin_bin	Pregabalin (binary)
GABA_npr	GABA (prescriptions)
GABA_bin	GABA (binary)
gastroparesia_bin	Gastroparesia drugs (binary)
gastroparesia_dose	Gastroparesia drugs (max dose)
gastroparesia_npr	Gastroparesia drugs (prescriptions)
glucocorticoid_injec_bin	Glucocorticoid injectable (binary)
glucocorticoid_injec_npr	Glucocorticoid injectable (prescriptions)
glucocorticoid_local_npr	Glucocorticoid local (prescriptions)
glucocorticoid_local_nap	Glucocorticoid local (different active principles)
glucocorticoid_local_bin	Glucocorticoid local (binary)
betamethasone_local_npr	Betamethasone (prescriptions)
betamethasone_local_bin	Betamethasone (binary)
hydrocortisone_local_npr	Hydrocortisone (prescriptions)
hydrocortisone_local_bin	Hydrocortisone (binary)
triamcinolone_local_npr	Triamcinolone (prescriptions)
triamcinolone_local_bin	Triamcinolone (binary)
glucocorticoid_general_npr	Glucocorticoid (prescriptions)
glucocorticoid_general_nap	Glucocorticoid (different active principles)
glucocorticoid_general_bin	Glucocorticoid (binary)
hydrocortisone_general_dose	Hydrocortisone (max dose)
hydrocortisone_general_bin	Hydrocortisone (binary)
hydrocortisone_general_npr	Hydrocortisone (prescriptions)
Feature	Description
methylprednisolone_general_dose	Methylprednisolone (max dose)
methylprednisolone_general_bin	Methylprednisolone (binary)
methylprednisolone_general_npr	Methylprednisolone (prescriptions)
prednisone_general_dose	Prednisone (max dose)
prednisone_general_bin	Prednisone (binary)
prednisone_general_npr	Prednisone (prescriptions)
LtypeCaChB_nap	L type calcium channel blocker (different active principles)
LtypeCaChB_bin	L type calcium channel blocker (binary)
LtypeCaChB_npr	L type calcium channel blocker (prescriptions)
amlodipine_dose	Amlodipine (max dose)
amlodipine_bin	Amlodipine (binary)
protonpumpinhibitor_nap	Proton pump inhibitor (different active principles)
protonpumpinhibitor_bin	Proton pump inhibitor (binary)
protonpumpinhibitor_npr	Proton pump inhibitor (prescriptions)
statin_nap	Statin (different active principles)
statin_npr	Statin (prescriptions)
statin_bin	Statin (binary)
atorvastatin_dose	Atorvastatin (max dose)
lovastatin_dose	Lovastatin (max dose)
pravastatin_dose	Pravastatin (max dose)
rosuvastatin_dose	Rosuvastatin (max dose)
simvastatin_dose	Simvastatin (max dose)
atorvastatin_bin	Atorvastatin (binary)
lovastatin_bin	Lovastatin (binary)
pravastatin_bin	Pravastatin (binary)
rosuvastatin_bin	Rosuvastatin (binary)
simvastatin_bin	Simvastatin (binary)
statin_dose_adjusted	Statin
thiazide_nap	Thiazide (different active principles)
thiazide_bin	Thiazide (binary)
thiazide_npr	Thiazide (prescriptions)
hydrochlorothiazide_dose	Hydrochlorothiazide (max dose)
niacin_npr	Niacin (prescriptions)
niacin_bin	Niacin (binary)
ezetimibe_npr	Ezetimibe (prescriptions)
ezetimibe_bin	Ezetimibe (binary)
antilipid_npr	Antilipemics (prescriptions)
antilipid_bin	Antilipemics (binary)
nasal_npr	Nasal route (prescriptions)
inhalation_npr	Inhalation route (prescriptions)
otic_nmed	Otic route (number of different drugs)
otic_nap	Otic route (different active principles)
otic_bin	Otic route (binary)
otic_npr	Otic route (prescriptions)
Feature	Description
allergy_inflam_opht_nap	Ophtalmic allergy inflamatory (different active principles)
allergy_inflam_opht_bin	Ophtalmic allergy inflamatory (binary)
allergy_inflam_opht_npr	Ophtalmic allergy inflamatory (prescriptions)
antibiotic_opht_nap	Ophtalmic antibiotic (different active principles)
antibiotic_opht_bin	Ophtalmic antibiotic (binary)
antibiotic_opht_npr	Ophtalmic antibiotic (prescriptions)
glaucoma_opht_nap	Ophtalmic glaucoma (different active principles)
glaucoma_opht_bin	Ophtalmic glaucoma (binary)
glaucoma_opht_npr	Ophtalmic glaucoma (prescriptions)
oral_contracep_npr	Oral contraceptive (prescriptions)
oral_contracep_bin	Oral contraceptive (binary)
no_oral_contracep_npr	No oral contraceptive (prescriptions)
no_oral_contracep_bin	No oral contraceptive (binary)
alfa1blocker_npr	Alfa1 blocker (prescriptions)
calcium_npr	Calcium (prescriptions)
calcium_bin	Calcium (binary)
coxib_npr	Coxib (prescriptions)
digoxin_npr	Digoxin (prescriptions)
laxatives_npr	Laxatives (prescriptions)
laxatives_bin	Laxatives (binary)
fiveareductase_npr	5a-reductase (prescriptions)
iron_npr	Iron (prescriptions)
loopdiuretic_bin	Loop diuretic (binary)
Kdiuretic_npr	K-diuteric (prescriptions)
Kdiuretic_bin	K-diuretic (binary)
isosorbide_npr	Isosorbide (prescriptions)
omega_3_npr	Omega-3 (prescriptions)
potassium_chloride_bin	Potassium chloride (binary)
isopropyl_npr	Isopropyl (prescriptions)
null_npr	Null medication description (prescriptions)
osteoporosis_bin	Osteoporosis drugs (binary)
alkylamine_bin	Alkylamine (binary)
amphetamine_npr	Amphetamine (prescriptions)
BPOther_npr	Blood preassure other drugs (prescriptions)
BPOther_bin	Blood preassure other drugs (binary)
triptan_npr	Triptan (prescriptions)
corticosteroids_npr	Corticosteroids (prescriptions)
gout_npr	Gout drugs (prescriptions)
gout_bin	Gout drugs (binary)
vitamin_bin	Vitamin (binary)
active_principle	Total active principles
prescripts	Total prescriptions
medication_wo_prescript	Medication without prescription
nomedication	No medication at all

